wwwwwwwwwwwwwwwwwwwwwwwww
w p                     w
w     wwwwwwwwwwwwwwwwwww
w                       w
w   wwwwwwwwwwwww       w
w                       w
w           wwww        w
w                       w
w                       w
w                       w
w                       w
w                       w
w                       w
w                       w
w                       w
w                       w
w                       w
w                     g w
w                       w
wwwwwwwwwwwwwwwwwwwwwwwww