wwwwwwwwwwwwwwwwwwwwwwwww
w p               e     w
w     wwwwwwwwwwwwwwwwwww
w            e          w
w   wwwwwwwwwwwww       w
w                       w
w           wwww        w
w                       w
w                       w
w             e         w
w                       w
w                       w
w                       w
w                       w
w                       w
w                       w
w                       w
w                     g w
w                       w
wwwwwwwwwwwwwwwwwwwwwwwww